"bG" = (/obj/machinery/light{dir = 8},/obj/machinery/power/apc/hyper,/obj/structure/cable,/obj/structure/dropprop,/obj/structure/droppod,/turf/open/floor/mainship,/area/mainship/hallways/port_hallway{outside = 0; name = "NTC Eagle Dropship"})
"bN" = (/obj/effect/landmark/start/latejoin,/obj/effect/landmark/start/job/crash/squadmarine,/turf/open/floor/mainship,/area/mainship/hallways/port_hallway{outside = 0; name = "NTC Eagle Dropship"})
"bQ" = (/obj/structure/droppod,/obj/structure/dropprop,/turf/open/floor/mainship/cargo,/area/mainship/hallways/port_hallway{outside = 0; name = "NTC Eagle Dropship"})
"cv" = (/obj/structure/ladder{id = "eagleladder2"},/obj/effect/landmark/start/job/corporateliaison,/turf/open/floor/plating/plating_catwalk,/area/mainship/hallways/port_hallway{outside = 0; name = "NTC Eagle Dropship"})
"di" = (/obj/structure/cable,/obj/structure/cable,/turf/open/floor/plating/plating_catwalk,/area/mainship/hallways/port_hallway{outside = 0; name = "NTC Eagle Dropship"})
"dB" = (/obj/structure/shuttle/engine/propulsion/burst/right,/turf/open/space/basic,/area/mainship/hallways/port_hallway{outside = 0; name = "NTC Eagle Dropship"})
"dY" = (/obj/machinery/computer/droppod_control,/obj/structure/table/mainship,/turf/open/floor/mainship/floor,/area/mainship/hallways/port_hallway{outside = 0; name = "NTC Eagle Dropship"})
"eb" = (/obj/machinery/door/poddoor/shutters/transit{dir = 2; id = "nuhuh"},/obj/machinery/door/poddoor/shutters/transit{dir = 2; id = "nuhuh"},/turf/open/floor/plating/plating_catwalk,/area/mainship/hallways/port_hallway{outside = 0; name = "NTC Eagle Dropship"})
"fD" = (/obj/structure/cable,/obj/structure/cable,/obj/effect/landmark/start/job/cmo,/turf/open/floor/plating/plating_catwalk,/area/mainship/hallways/port_hallway{outside = 0; name = "NTC Eagle Dropship"})
"fU" = (/obj/machinery/light{dir = 4},/obj/machinery/cryopod,/turf/open/floor/mainship,/area/mainship/hallways/port_hallway{outside = 0; name = "NTC Eagle Dropship"})
"ge" = (/obj/structure/cable,/obj/machinery/loadout_vendor,/turf/open/floor/plating/plating_catwalk,/area/mainship/hallways/port_hallway{outside = 0; name = "NTC Eagle Dropship"})
"gp" = (/obj/machinery/cryopod/right,/obj/machinery/light{dir = 8},/obj/structure/cable,/obj/machinery/power/apc/mainship/hardened,/turf/open/floor/mainship,/area/mainship/hallways/port_hallway{outside = 0; name = "NTC Eagle Dropship"})
"gS" = (/turf/open/floor/mainship_hull,/area/mainship/hallways/port_hallway{outside = 0; name = "NTC Eagle Dropship"})
"hy" = (/obj/structure/ladder{id = "eagleladder2"},/turf/open/floor/plating/plating_catwalk,/area/mainship/hallways/port_hallway{outside = 0; name = "NTC Eagle Dropship"})
"hY" = (/obj/machinery/cryopod/right,/obj/machinery/light{dir = 8},/turf/open/floor/mainship,/area/mainship/hallways/port_hallway{outside = 0; name = "NTC Eagle Dropship"})
"iC" = (/obj/structure/cable,/obj/effect/landmark/start/job/captain,/turf/open/floor/plating/plating_catwalk,/area/mainship/hallways/port_hallway{outside = 0; name = "NTC Eagle Dropship"})
"jf" = (/obj/structure/cable,/obj/structure/ladder{id = "eagleladder1"},/obj/effect/landmark/start/job/chiefshipengineer,/turf/open/floor/plating/plating_catwalk,/area/mainship/hallways/port_hallway{outside = 0; name = "NTC Eagle Dropship"})
"jR" = (/obj/effect/landmark/start/job/fieldcommander,/obj/effect/landmark/start/latejoin,/turf/open/floor/mainship,/area/mainship/hallways/port_hallway{outside = 0; name = "NTC Eagle Dropship"})
"jX" = (/obj/machinery/light{dir = 1},/obj/machinery/vending/marine/shared,/turf/open/floor/mainship,/area/mainship/hallways/port_hallway{outside = 0; name = "NTC Eagle Dropship"})
"kO" = (/obj/machinery/cryopod,/turf/open/floor/mainship,/area/mainship/hallways/port_hallway{outside = 0; name = "NTC Eagle Dropship"})
"me" = (/obj/structure/window/framed/mainship,/turf/open/floor/mainship_hull,/area/mainship/hallways/port_hallway{outside = 0; name = "NTC Eagle Dropship"})
"nB" = (/obj/structure/cable,/turf/closed/wall/mainship,/area/mainship/hallways/port_hallway{outside = 0; name = "NTC Eagle Dropship"})
"nK" = (/obj/structure/cable,/obj/effect/landmark/start/job/researcher,/turf/open/floor/plating/plating_catwalk,/area/mainship/hallways/port_hallway{outside = 0; name = "NTC Eagle Dropship"})
"pn" = (/obj/structure/cable,/obj/effect/landmark/start/job/squadengineer,/turf/open/floor/plating/plating_catwalk,/area/mainship/hallways/port_hallway{outside = 0; name = "NTC Eagle Dropship"})
"pF" = (/obj/structure/dropprop,/obj/structure/droppod,/turf/open/floor/mainship/mono,/area/mainship/hallways/port_hallway{outside = 0; name = "NTC Eagle Dropship"})
"tq" = (/obj/structure/window/framed/mainship/spaceworthy{icon_state = "col_window12"},/turf/open/space/basic,/area/mainship/hallways/port_hallway{outside = 0; name = "NTC Eagle Dropship"})
"va" = (/obj/machinery/light{dir = 1},/obj/structure/table/mainship,/obj/machinery/computer/marine_card,/turf/open/floor/mainship,/area/mainship/hallways/port_hallway{outside = 0; name = "NTC Eagle Dropship"})
"vl" = (/obj/machinery/cryopod,/obj/machinery/light{dir = 4},/turf/open/floor/mainship,/area/mainship/hallways/port_hallway{outside = 0; name = "NTC Eagle Dropship"})
"vD" = (/obj/effect/landmark/start/job/shiptech,/obj/effect/landmark/start/latejoin,/turf/open/floor/mainship,/area/mainship/hallways/port_hallway{outside = 0; name = "NTC Eagle Dropship"})
"vV" = (/obj/structure/cable,/obj/effect/landmark/start/job/squadsmartgunner,/turf/open/floor/plating/plating_catwalk,/area/mainship/hallways/port_hallway{outside = 0; name = "NTC Eagle Dropship"})
"wO" = (/obj/structure/window/framed/mainship/spaceworthy{icon_state = "col_window1"},/turf/open/floor/mainship_hull,/area/mainship/hallways/port_hallway{outside = 0; name = "NTC Eagle Dropship"})
"yh" = (/obj/effect/landmark/start/job/squadmarine,/obj/effect/landmark/start/latejoin,/turf/open/floor/mainship,/area/mainship/hallways/port_hallway{outside = 0; name = "NTC Eagle Dropship"})
"yu" = (/obj/structure/cable,/turf/open/floor/plating/plating_catwalk,/area/mainship/hallways/port_hallway{outside = 0; name = "NTC Eagle Dropship"})
"zQ" = (/turf/open/space/basic,/area/space)
"zU" = (/obj/machinery/computer/camera_advanced/overwatch,/obj/structure/cable,/turf/open/floor/plating/plating_catwalk,/area/mainship/hallways/port_hallway{outside = 0; name = "NTC Eagle Dropship"})
"Bq" = (/obj/machinery/cryopod/right,/turf/open/floor/mainship,/area/mainship/hallways/port_hallway{outside = 0; name = "NTC Eagle Dropship"})
"Fl" = (/obj/effect/landmark/start/job/synthetic,/obj/effect/landmark/start/latejoin,/turf/open/floor/mainship,/area/mainship/hallways/port_hallway{outside = 0; name = "NTC Eagle Dropship"})
"Gp" = (/obj/structure/window/framed/mainship,/turf/open/floor/mainship,/area/mainship/hallways/port_hallway{outside = 0; name = "NTC Eagle Dropship"})
"GO" = (/obj/effect/landmark/start/job/requisitionsofficer,/obj/effect/landmark/start/latejoin,/turf/open/floor/mainship,/area/mainship/hallways/port_hallway{outside = 0; name = "NTC Eagle Dropship"})
"Ho" = (/obj/structure/bed/chair/dropship/pilot{dir = 1},/obj/effect/landmark/start/job/crash/pilotofficer,/turf/open/floor/mainship,/area/mainship/hallways/port_hallway{outside = 0; name = "NTC Eagle Dropship"})
"HV" = (/obj/machinery/light{dir = 4},/obj/structure/dropprop,/obj/structure/droppod,/turf/open/floor/mainship,/area/mainship/hallways/port_hallway{outside = 0; name = "NTC Eagle Dropship"})
"KF" = (/obj/effect/landmark/start/job/squadleader,/obj/effect/landmark/start/latejoin,/turf/open/floor/mainship,/area/mainship/hallways/port_hallway{outside = 0; name = "NTC Eagle Dropship"})
"KW" = (/obj/machinery/light{dir = 1},/obj/machinery/marine_selector/clothes,/turf/open/floor/mainship,/area/mainship/hallways/port_hallway{outside = 0; name = "NTC Eagle Dropship"})
"LK" = (/obj/machinery/light{dir = 1},/obj/structure/table/mainship,/obj/machinery/computer/security/marine_network,/turf/open/floor/mainship,/area/mainship/hallways/port_hallway{outside = 0; name = "NTC Eagle Dropship"})
"Ma" = (/obj/machinery/telecomms/relay/preset/telecomms,/obj/structure/cable,/turf/open/floor/plating/plating_catwalk,/area/mainship/hallways/port_hallway{outside = 0; name = "NTC Eagle Dropship"})
"MI" = (/obj/structure/cable,/obj/effect/landmark/start/latejoin,/obj/effect/landmark/start/job/crash/squadmarine,/turf/open/floor/plating/plating_catwalk,/area/mainship/hallways/port_hallway{outside = 0; name = "NTC Eagle Dropship"})
"MX" = (/obj/effect/landmark/start/job/pilotofficer,/obj/effect/landmark/start/latejoin,/turf/open/floor/mainship,/area/mainship/hallways/port_hallway{outside = 0; name = "NTC Eagle Dropship"})
"Nu" = (/obj/structure/cable,/obj/effect/landmark/start/job/medicalofficer,/turf/open/floor/plating/plating_catwalk,/area/mainship/hallways/port_hallway{outside = 0; name = "NTC Eagle Dropship"})
"NV" = (/obj/structure/cable,/obj/structure/ladder{id = "eagleladder1"},/turf/open/floor/plating/plating_catwalk,/area/mainship/hallways/port_hallway{outside = 0; name = "NTC Eagle Dropship"})
"PJ" = (/obj/structure/shuttle/engine/propulsion/burst/right,/turf/open/floor/mainship_hull,/area/mainship/hallways/port_hallway{outside = 0; name = "NTC Eagle Dropship"})
"SC" = (/obj/machinery/light{dir = 8},/obj/structure/dropprop,/obj/structure/droppod,/turf/open/floor/mainship,/area/mainship/hallways/port_hallway{outside = 0; name = "NTC Eagle Dropship"})
"Uf" = (/obj/machinery/door/airlock/mainship/command/canterbury{dir = 1; name = "\improper Command Cockpit"},/obj/structure/cable,/turf/open/floor/plating/plating_catwalk,/area/mainship/hallways/port_hallway{outside = 0; name = "NTC Eagle Dropship"})
"Ug" = (/obj/effect/landmark/start/job/squadcorpsman,/obj/effect/landmark/start/latejoin,/turf/open/floor/mainship,/area/mainship/hallways/port_hallway{outside = 0; name = "NTC Eagle Dropship"})
"Uh" = (/obj/machinery/door/poddoor/shutters/transit{dir = 2; id = "nuhuh"},/turf/open/floor/plating/plating_catwalk,/area/mainship/hallways/port_hallway{outside = 0; name = "NTC Eagle Dropship"})
"Um" = (/turf/closed/wall/mainship,/area/mainship/hallways/port_hallway{outside = 0; name = "NTC Eagle Dropship"})
"WD" = (/obj/structure/dropprop,/obj/structure/droppod,/turf/open/floor/mainship,/area/mainship/hallways/port_hallway{outside = 0; name = "NTC Eagle Dropship"})
"YE" = (/turf/open/floor/mainship,/area/mainship/hallways/port_hallway{outside = 0; name = "NTC Eagle Dropship"})
"ZI" = (/obj/effect/landmark/start/job/staffofficer,/obj/effect/landmark/start/latejoin,/turf/open/floor/mainship,/area/mainship/hallways/port_hallway{outside = 0; name = "NTC Eagle Dropship"})

(1,1,1) = {"
zQzQzQzQzQzQzQzQzQzQzQzQzQzQzQzQzQzQzQzQzQzQzQzQzQ
zQzQzQzQzQzQzQzQzQzQzQzQzQzQzQzQzQzQzQzQzQzQzQzQzQ
zQzQzQzQzQzQzQzQzQzQzQzQzQzQzQzQzQzQzQzQzQzQzQzQzQ
zQzQzQzQzQzQzQzQzQzQzQzQzQzQzQzQzQzQzQzQzQzQzQzQzQ
zQzQzQzQzQzQzQzQzQzQzQzQzQzQzQzQzQzQzQzQzQzQzQzQzQ
zQzQzQzQzQzQzQzQzQzQzQzQzQzQzQzQzQzQzQzQzQzQzQzQzQ
zQzQzQzQzQzQzQzQzQzQzQzQUmzQzQzQzQzQzQzQzQzQzQzQzQ
zQzQzQzQzQzQzQzQzQzQzQUmUmUmzQzQzQzQzQzQzQzQzQzQzQ
zQzQzQzQzQzQzQzQzQzQUmUmgeUmUmzQzQzQzQzQzQzQzQzQzQ
zQzQzQzQzQzQzQzQzQgSmejXyuKWmegSzQzQzQzQzQzQzQzQzQ
zQzQzQzQzQzQzQzQgSUmnBNVdihyUmUmgSzQzQzQzQzQzQzQzQ
zQzQzQzQzQzQzQgSgSUmbGWDyubQHVUmgSgSzQzQzQzQzQzQzQ
zQzQzQzQzQzQzQgSzQmeWDWDyubQWDmezQgSzQzQzQzQzQzQzQ
zQzQzQzQzQzQzQzQzQUmWDWDyubQWDUmzQzQzQzQzQzQzQzQzQ
zQzQzQzQzQzQzQzQzQUmWDWDyubQWDUmzQzQzQzQzQzQzQzQzQ
zQzQzQzQzQzQzQzQzQmeSCWDyupFHVmezQzQzQzQzQzQzQzQzQ
zQzQzQzQzQzQzQzQzQUmUmYEdidYUmUmzQzQzQzQzQzQzQzQzQ
zQzQzQzQzQzQzQzQgSPJUmebUhebUmPJgSzQzQzQzQzQzQzQzQ
zQzQzQzQzQzQzQzQgSgSUmzQzQzQUmgSgSzQzQzQzQzQzQzQzQ
zQzQzQzQzQzQzQzQgSzQzQzQzQzQzQzQgSzQzQzQzQzQzQzQzQ
zQzQzQzQzQzQzQzQzQzQzQzQzQzQzQzQzQzQzQzQzQzQzQzQzQ
zQzQzQzQzQzQzQzQzQzQzQzQzQzQzQzQzQzQzQzQzQzQzQzQzQ
zQzQzQzQzQzQzQzQzQzQzQzQzQzQzQzQzQzQzQzQzQzQzQzQzQ
zQzQzQzQzQzQzQzQzQzQzQzQzQzQzQzQzQzQzQzQzQzQzQzQzQ
zQzQzQzQzQzQzQzQzQzQzQzQzQzQzQzQzQzQzQzQzQzQzQzQzQ
"}
(1,1,2) = {"
zQzQzQzQzQzQzQzQzQzQzQzQzQzQzQzQzQzQzQzQzQzQzQzQzQ
zQzQzQzQzQzQzQzQzQzQzQzQzQzQzQzQzQzQzQzQzQzQzQzQzQ
zQzQzQzQzQzQzQzQzQzQzQzQzQzQzQzQzQzQzQzQzQzQzQzQzQ
zQzQzQzQzQzQzQzQzQzQzQzQzQzQzQzQzQzQzQzQzQzQzQzQzQ
zQzQzQzQzQzQzQzQzQzQzQzQzQzQzQzQzQzQzQzQzQzQzQzQzQ
zQzQzQzQzQzQzQzQzQzQzQtqtqtqzQzQzQzQzQzQzQzQzQzQzQ
zQzQzQzQzQzQzQzQzQzQUmwOMawOUmzQzQzQzQzQzQzQzQzQzQ
zQzQzQzQzQzQzQzQzQzQwOLKzUvawOzQzQzQzQzQzQzQzQzQzQ
zQzQzQzQzQzQzQzQzQzQwOHoiCHowOzQzQzQzQzQzQzQzQzQzQ
zQzQzQzQzQzQzQzQzQgSUmGpUfGpUmgSzQzQzQzQzQzQzQzQzQ
zQzQzQzQzQzQzQzQgSUmnBjffDcvUmUmgSzQzQzQzQzQzQzQzQ
zQzQzQzQzQzQzQgSgSUmgpjRNuMXvlUmgSgSzQzQzQzQzQzQzQ
zQzQzQzQzQzQgSgSgSmeBqGOnKvDkOmegSgSgSzQzQzQzQzQzQ
zQzQzQzQzQgSgSgSgSUmhYUgpnKFfUUmgSgSgSgSzQzQzQzQzQ
zQzQzQzQzQzQgSdBdBUmBqyhvVZIkOUmdBdBgSzQzQzQzQzQzQ
zQzQzQzQzQzQzQzQzQmehYbNMIFlvlmezQzQzQzQzQzQzQzQzQ
zQzQzQzQzQzQzQzQgSUmUmBqMIkOUmUmgSzQzQzQzQzQzQzQzQ
zQzQzQzQzQzQzQgSgSPJUmUmUmUmUmPJgSgSzQzQzQzQzQzQzQ
zQzQzQzQzQzQzQgSgSzQUmzQUmzQUmzQgSgSzQzQzQzQzQzQzQ
zQzQzQzQzQzQzQzQzQzQzQzQUmzQzQzQzQzQzQzQzQzQzQzQzQ
zQzQzQzQzQzQzQzQzQzQzQzQzQzQzQzQzQzQzQzQzQzQzQzQzQ
zQzQzQzQzQzQzQzQzQzQzQzQzQzQzQzQzQzQzQzQzQzQzQzQzQ
zQzQzQzQzQzQzQzQzQzQzQzQzQzQzQzQzQzQzQzQzQzQzQzQzQ
zQzQzQzQzQzQzQzQzQzQzQzQzQzQzQzQzQzQzQzQzQzQzQzQzQ
zQzQzQzQzQzQzQzQzQzQzQzQzQzQzQzQzQzQzQzQzQzQzQzQzQ
"}
