//MAP CONVERTED BY dmm2tgm.py THIS HEADER COMMENT PREVENTS RECONVERSION, DO NOT REMOVE
"a" = (
/obj/structure/closet/toolcloset,
/turf/open/floor/mainship/blue{
	dir = 4
	},
/area/shuttle/minidropship)
"b" = (
/obj/effect/attach_point/weapon/minidropship,
/turf/closed/wall/mainship/outer/reinforced,
/area/shuttle/minidropship)
"h" = (
/turf/open/floor/mainship/orange{
	dir = 4
	},
/area/shuttle/minidropship)
"i" = (
/obj/structure/bed/chair/dropship/passenger{
	dir = 4
	},
/obj/machinery/light{
	dir = 8
	},
/obj/machinery/vending/nanomed,
/turf/open/floor/mainship/orange{
	dir = 9
	},
/area/shuttle/minidropship)
"j" = (
/obj/machinery/door_control{
	name = "outer door-control";
	pixel_y = 32;
	id = "minidropship_podlock"
	},
/obj/structure/bed/chair/dropship/passenger{
	dir = 8
	},
/obj/machinery/light{
	dir = 4
	},
/turf/open/floor/mainship/orange{
	dir = 5
	},
/area/shuttle/minidropship)
"n" = (
/obj/structure/window/framed/mainship/spaceworthy{
	icon_state = "col_window12"
	},
/turf/open/floor/mainship_hull,
/area/shuttle/minidropship)
"r" = (
/obj/structure/bed/chair/dropship/pilot{
	dir = 1
	},
/turf/open/floor/mainship/floor,
/area/shuttle/minidropship)
"s" = (
/turf/open/floor/mainship/floor,
/area/shuttle/minidropship)
"u" = (
/obj/machinery/door/airlock/hatch/cockpit/two,
/turf/open/floor/mainship/orange,
/area/shuttle/minidropship)
"v" = (
/obj/machinery/door/poddoor/shutters/transit{
	dir = 2
	},
/obj/machinery/door/poddoor/mainship/open{
	dir = 2;
	id = "minidropship_podlock"
	},
/obj/structure/barricade/plasteel,
/turf/open/floor/mainship/orange{
	dir = 10
	},
/area/shuttle/minidropship)
"w" = (
/obj/machinery/light{
	dir = 4
	},
/obj/structure/bed/chair/dropship/passenger{
	dir = 8
	},
/turf/open/floor/mainship/orange{
	dir = 4
	},
/area/shuttle/minidropship)
"y" = (
/obj/machinery/computer/camera_advanced/shuttle_docker/minidropship,
/obj/machinery/light{
	dir = 1
	},
/turf/open/floor/mainship/floor,
/area/shuttle/minidropship)
"B" = (
/turf/closed/wall/mainship/outer/reinforced,
/area/shuttle/minidropship)
"D" = (
/obj/machinery/light{
	dir = 8
	},
/obj/structure/bed/chair/dropship/passenger{
	dir = 4
	},
/turf/open/floor/mainship/orange{
	dir = 8
	},
/area/shuttle/minidropship)
"E" = (
/turf/template_noop,
/area/space)
"F" = (
/obj/item/stack/barbed_wire/small_stack{
	amount = 7
	},
/obj/docking_port/mobile/marine_dropship/minidropship,
/turf/open/floor/mainship/orange{
	dir = 1
	},
/area/shuttle/minidropship)
"I" = (
/obj/structure/shuttle/engine/propulsion/burst/right,
/turf/template_noop,
/area/shuttle/minidropship)
"K" = (
/obj/structure/window/framed/mainship/spaceworthy{
	icon_state = "col_window1"
	},
/turf/open/floor/mainship_hull,
/area/shuttle/minidropship)
"L" = (
/obj/structure/table/mainship,
/obj/machinery/cell_charger,
/turf/open/floor/mainship/blue{
	dir = 9
	},
/area/shuttle/minidropship)
"N" = (
/obj/machinery/door/poddoor/shutters/transit{
	dir = 2
	},
/obj/machinery/door/poddoor/mainship/open{
	dir = 2;
	id = "minidropship_podlock"
	},
/obj/structure/barricade/plasteel,
/turf/open/floor/mainship/orange,
/area/shuttle/minidropship)
"O" = (
/obj/structure/barricade/plasteel{
	dir = 8
	},
/obj/machinery/door/poddoor/mainship/open{
	id = "minidropship_podlock"
	},
/obj/machinery/door/poddoor/shutters/transit,
/turf/open/floor/mainship/orange{
	dir = 4
	},
/area/shuttle/minidropship)
"P" = (
/obj/structure/table/mainship,
/obj/structure/table/mainship,
/obj/item/storage/firstaid/adv{
	pixel_x = 6;
	pixel_y = 6
	},
/obj/item/flashlight,
/turf/open/floor/mainship/blue{
	dir = 5
	},
/area/shuttle/minidropship)
"R" = (
/obj/machinery/door/poddoor/shutters/transit{
	dir = 2
	},
/obj/machinery/door/poddoor/mainship/open{
	dir = 2;
	id = "minidropship_podlock"
	},
/obj/structure/barricade/plasteel,
/turf/open/floor/mainship/orange{
	dir = 6
	},
/area/shuttle/minidropship)
"S" = (
/turf/open/floor/mainship/blue{
	dir = 8
	},
/area/shuttle/minidropship)
"T" = (
/obj/structure/barricade/plasteel{
	dir = 4
	},
/obj/machinery/door/poddoor/mainship/open{
	id = "minidropship_podlock"
	},
/obj/machinery/door/poddoor/shutters/transit,
/turf/open/floor/mainship/orange{
	dir = 8
	},
/area/shuttle/minidropship)
"U" = (
/obj/structure/largecrate/supply/supplies/mre,
/turf/open/floor/mainship/orange{
	dir = 4
	},
/area/shuttle/minidropship)
"V" = (
/turf/open/floor/mainship/orange{
	dir = 8
	},
/area/shuttle/minidropship)
"Y" = (
/obj/effect/attach_point/crew_weapon/minidropship,
/turf/open/floor/mainship/floor,
/area/shuttle/minidropship)

(1,1,1) = {"
E
E
b
I
E
E
E
B
I
"}
(2,1,1) = {"
B
K
B
B
B
O
O
B
B
"}
(3,1,1) = {"
K
L
S
B
i
V
V
D
v
"}
(4,1,1) = {"
n
y
r
u
F
Y
s
s
N
"}
(5,1,1) = {"
K
P
a
B
j
U
h
w
R
"}
(6,1,1) = {"
B
K
B
B
B
T
T
B
B
"}
(7,1,1) = {"
E
E
b
I
E
E
E
B
I
"}
